chorégraphique	adjective
putain	noun	feminine
atour	noun	masculine
gargantua	noun	masculine
baroque	adjective
morfil	noun	masculine
fougeraie	noun	feminine
parallaxe	noun	feminine
dispersoïde	noun	masculine
versatile	adjective
surabonder	verb
autopompe	noun	feminine
diagnostique	adjective
semis	noun	masculine
styler	verb
râper	verb
banjo	noun	masculine
déblai	noun	masculine
accumuler	verb
psycholinguistique	noun	feminine
hybridité	noun	feminine
dinosaurien	noun	masculine
rationnement	noun	masculine
endommager	verb
mouler	verb
soude	noun	feminine
embouquer	verb
stannifère	adjective
cuisinière	noun	feminine
contresens	noun	masculine
caramboler	verb
sextuor	noun	masculine
pupillaire	adjective
lapidaire	adjective
âprement	adjective
epsilon	noun	masculine
gratuité	noun	feminine
formuer	verb
voltampère	noun	masculine
réité	noun	feminine
docimasie	noun	feminine
arrondissement	noun	masculine
isorel	noun	masculine
chrysoprase	noun	feminine
repentance	noun	feminine
dispensation	noun	feminine
butyle	noun	masculine
prunelaie	noun	feminine
dichroïque	adjective
succomber	verb
doxologie	noun	feminine
séparatisme	noun	masculine
marge	noun	feminine
minimum	noun	masculine
médicament	noun	masculine
complaisamment	adjective
reconsidérer	verb
pentacle	noun	masculine
essence	noun	feminine
scripturaire	adjective
délarder	verb
exequatur	noun	masculine
ricocher	verb
notion	noun	feminine
simoniaque	adjective
artilleur	noun	masculine
orfèvre	noun	masculine
tâtonnement	noun	masculine
calage	noun	masculine
performance	noun	feminine
skating	noun	masculine
banche	noun	feminine
aérologique	adjective
cypris	noun	feminine
calicot	noun	masculine
phagédénique	adjective
tenable	adjective
naturaliste	adjective
bondrée	noun	feminine
séduction	noun	feminine
décours	noun	masculine
emménagogue	adjective
arbalestrille	noun	feminine
acritique	adjective
acidose	adjective
condenseur	noun	masculine
téton	noun	masculine
enhardir	verb
bassinage	noun	masculine
mirette	noun	feminine
abandonnataire	noun	masculine
pessimisme	noun	masculine
marivaudage	noun	masculine
corybante	noun	masculine
antiphrase	noun	feminine
méthodiste	adjective
provoquer	verb
stratigraphie	noun	feminine
ruinure	noun	feminine
tégénaire	noun	feminine
bruitage	noun	masculine
piétin	noun	masculine
communiser	verb
tétralogie	noun	feminine
hydrolat	noun	masculine
picaro	noun	masculine
interpsychologie	noun	feminine
hydarthrose	noun	feminine
opaliser	verb
polyarthrite	noun	feminine
couque	noun	masculine
disgrâce	noun	feminine